Category,Name,Nodes,Tokens1,Tokens2,ΔTokens,δToknes,Length1,Length2,ΔLength,δLength,Tide1,Tide2,ΔTide2,δTide2,Essence1,Essence2,ΔEssence2,δEssence2,R(T/L),R(E/L),R(E/T)
class,NotImplementedExceptionTest,202,259,259,0,0.0,1683,1527,156,-0.10216110019646374,1393,1393,0,0.0,1320,1298,22,-0.016949152542372836,0.827688651218063,0.7843137254901961,0.9475951184493898
class,ExtendedMessageFormatTest,1964,2383,2354,29,-0.012319456244689997,20204,14733,5471,-0.3713432430597978,13264,13264,0,0.0,11535,11338,197,-0.01737519844769797,0.6565036626410612,0.5709265491981785,0.8696471652593486
class,StrBuilderTest,10451,14658,14663,-5,3.4099433949397184E-4,70468,55860,14608,-0.26151092015753674,48911,48911,0,0.0,48842,47676,1166,-0.024456749727326033,0.6940880967247545,0.693108928875518,0.9985892743963526
class,FormattableUtilsTest,1135,1881,1881,0,0.0,7146,6543,603,-0.09215955983493807,6090,6090,0,0.0,6049,5689,360,-0.06328001406222539,0.852225020990764,0.8464875454799888,0.9932676518883415
class,WordUtilsTest,2323,3416,3416,0,0.0,19831,16878,2953,-0.17496148832800085,15347,15347,0,0.0,14894,14894,0,0.0,0.7738893651353941,0.7510463415864052,0.9704828305206229
class,StrSubstitutorTest,2742,3552,3533,19,-0.005377865836399653,26032,21580,4452,-0.20630213160333644,19173,19173,0,0.0,17683,17579,104,-0.00591614995164691,0.7365165949600492,0.679279348494161,0.9222865487925729
class,OctalUnescaperTest,236,296,296,0,0.0,2300,2032,268,-0.13188976377952755,1821,1821,0,0.0,1738,1738,0,0.0,0.7917391304347826,0.7556521739130435,0.9544206479956068
class,UnicodeUnpairedSurrogateRemoverTest,90,121,121,0,0.0,837,739,98,-0.13261163734776726,675,675,0,0.0,575,575,0,0.0,0.8064516129032258,0.6869772998805257,0.8518518518518519
class,EntityArraysTest,275,348,348,0,0.0,1608,1330,278,-0.20902255639097755,1095,1095,0,0.0,1014,1014,0,0.0,0.6809701492537313,0.6305970149253731,0.9260273972602739
class,NumericEntityUnescaperTest,211,251,251,0,0.0,2143,1871,272,-0.1453768038482095,1676,1676,0,0.0,1585,1585,0,0.0,0.7820811945870275,0.7396173588427438,0.9457040572792362
class,UnicodeEscaperTest,125,142,142,0,0.0,1064,960,104,-0.10833333333333339,870,870,0,0.0,787,787,0,0.0,0.8176691729323309,0.7396616541353384,0.9045977011494253
class,UnicodeUnescaperTest,116,131,131,0,0.0,1111,956,155,-0.16213389121338917,843,843,0,0.0,760,760,0,0.0,0.7587758775877588,0.684068406840684,0.9015421115065243
class,NumericEntityEscaperTest,171,191,191,0,0.0,1490,1323,167,-0.12622826908541196,1202,1202,0,0.0,1113,1113,0,0.0,0.8067114093959732,0.7469798657718121,0.9259567387687188
class,LookupTranslatorTest,137,173,173,0,0.0,1070,908,162,-0.1784140969162995,838,838,0,0.0,753,741,12,-0.0161943319838056,0.7831775700934579,0.7037383177570093,0.8985680190930787
class,CompositeFormatTest,260,288,286,2,-0.006993006993007089,2163,1886,277,-0.14687168610816537,1629,1629,0,0.0,1484,1456,28,-0.019230769230769162,0.753120665742025,0.686084142394822,0.910988336402701
class,StrBuilderAppendInsertTest,6838,9371,9358,13,-0.0013891857234451521,52009,39201,12808,-0.3267263590214535,33387,33387,0,0.0,33233,31822,1411,-0.0443403934385016,0.6419465861677787,0.6389855601915053,0.9953874262437475
class,StrTokenizerTest,4361,5850,5836,14,-0.002398903358464599,30061,24594,5467,-0.2222899894283159,21556,21556,0,0.0,21395,21087,308,-0.014606155451225789,0.7170752802634643,0.7117195036758591,0.9925310818333642
class,StrLookupTest,397,534,534,0,0.0,3279,2845,434,-0.1525483304042179,2517,2517,0,0.0,2207,2207,0,0.0,0.7676120768526989,0.6730710582494663,0.8768375049662296
class,StrMatcherTest,1105,1600,1600,0,0.0,8561,6494,2067,-0.31829380967046506,5860,5860,0,0.0,5791,5791,0,0.0,0.6844994743604719,0.6764396682630534,0.9882252559726963
class,ClassPathUtilsTest,400,498,498,0,0.0,3446,3167,279,-0.08809598989580048,2920,2920,0,0.0,2915,2915,0,0.0,0.8473592571096924,0.8459082994776552,0.9982876712328768
class,FractionTest,6900,9406,9277,129,-0.01390535733534537,45643,36292,9351,-0.2576600903780448,30313,30313,0,0.0,30268,29992,276,-0.009202453987730008,0.6641325066275223,0.6631465942203624,0.998515488404315
class,NumberUtilsTest,9134,12392,12189,203,-0.016654360488965514,70752,59528,11224,-0.1885499260852037,54187,54187,0,0.0,53187,52815,372,-0.007043453564328228,0.765872342831298,0.7517384667571235,0.9815453891154705
class,IEEE754rUtilsTest,459,616,616,0,0.0,3254,2847,407,-0.14295749912188271,2418,2418,0,0.0,2350,2350,0,0.0,0.7430854333128457,0.7221880762138906,0.9718775847808105
class,BitFieldTest,1425,2032,2028,4,-0.0019723865877712132,8949,7680,1269,-0.16523437500000004,6791,6791,0,0.0,6294,6290,4,-6.359300476947993E-4,0.7588557380712929,0.7033188065705666,0.9268149020762775
class,StringUtilsTrimStripTest,1370,1934,1934,0,0.0,11062,9449,1613,-0.17070589480368303,8454,8454,0,0.0,8375,8375,0,0.0,0.7642379316579281,0.7570963659374434,0.9906553110953394
class,StringUtilsEmptyBlankTest,500,697,697,0,0.0,3576,3248,328,-0.10098522167487678,2900,2900,0,0.0,2820,2820,0,0.0,0.8109619686800895,0.7885906040268457,0.9724137931034482
class,SystemDefaultsSwitchTest,227,285,261,24,-0.09195402298850586,1949,1600,349,-0.2181249999999999,1525,1525,0,0.0,1525,1463,62,-0.04237867395762129,0.7824525397639815,0.7824525397639815,1.0
@interface,SystemDefaults,26,31,31,0,0.0,479,447,32,-0.07158836689038028,415,415,0,0.0,150,150,0,0.0,0.8663883089770354,0.31315240083507306,0.3614457831325301
class,SystemDefaultsSwitch,198,252,243,9,-0.03703703703703698,2817,2186,631,-0.288655077767612,1946,1946,0,0.0,1061,983,78,-0.0793489318413021,0.6908058217962372,0.3766418175363862,0.5452209660842754
class,NotVisibleExceptionFactory,71,75,75,0,0.0,839,797,42,-0.05269761606022594,698,698,0,0.0,432,432,0,0.0,0.831942789034565,0.5148986889153755,0.6189111747851003
class,AnnotationUtilsTest,2024,2773,2757,16,-0.005803409503083001,17467,10438,7029,-0.6734048668327266,9904,9904,0,0.0,9899,9816,83,-0.008455582722086463,0.5670120799221389,0.5667258258430182,0.9994951534733441
class,ToStringBuilderTest,6016,7993,7960,33,-0.004145728643216051,47072,40234,6838,-0.16995575881095593,37105,37105,0,0.0,34561,33710,851,-0.025244734500148303,0.7882605370496261,0.7342156696125085,0.9314378116156852
class,NoClassNameToStringStyleTest,776,1088,1088,0,0.0,4862,4281,581,-0.13571595421630467,4067,4067,0,0.0,4009,3805,204,-0.053613666228646606,0.8364870423693953,0.8245577951460304,0.9857388738627981
class,ReflectionToStringBuilderExcludeTest,526,622,622,0,0.0,4108,3749,359,-0.09575886903174169,3439,3439,0,0.0,3434,3434,0,0.0,0.8371470301850049,0.8359298928919182,0.9985460889793545
class,SimpleToStringStyleTest,776,1088,1088,0,0.0,4721,4120,601,-0.14587378640776705,3906,3906,0,0.0,3825,3621,204,-0.05633802816901401,0.8273670832450752,0.810209701334463,0.9792626728110599
class,ReflectionToStringBuilderConcurrencyTest,391,448,442,6,-0.013574660633484115,3332,2683,649,-0.24189340290719352,2377,2377,0,0.0,1848,1820,28,-0.01538461538461533,0.7133853541416567,0.5546218487394958,0.777450567942785
class,ReflectionToStringBuilderExcludeWithAnnotationTest,114,128,128,0,0.0,1070,978,92,-0.09406952965235171,909,909,0,0.0,862,862,0,0.0,0.8495327102803738,0.805607476635514,0.9482948294829483
class,NoFieldNamesToStringStyleTest,885,1213,1213,0,0.0,5427,4816,611,-0.12686877076411962,4518,4518,0,0.0,4431,4227,204,-0.04826117814052511,0.8325041459369817,0.8164731896075179,0.9807436918990704
class,CompareToBuilderTest,9425,12404,12073,331,-0.027416549324939865,50768,43880,6888,-0.15697356426618048,38988,38988,0,0.0,38301,37920,381,-0.010047468354430489,0.7679640718562875,0.7544319256224393,0.9823791935980302
class,HashCodeBuilderAndEqualsBuilderTest,477,582,583,-1,0.0017152658662092923,4008,3399,609,-0.1791703442188879,2948,2948,0,0.0,2512,2518,-6,0.002382843526608447,0.7355289421157685,0.626746506986028,0.8521031207598372
class,ReflectionToStringBuilderTest,26,35,35,0,0.0,249,233,16,-0.06866952789699576,218,218,0,0.0,218,218,0,0.0,0.8755020080321285,0.8755020080321285,1.0
class,ToStringStyleConcurrencyTest,354,398,392,6,-0.015306122448979664,3019,2439,580,-0.23780237802378035,2200,2200,0,0.0,1672,1640,32,-0.019512195121951237,0.7287181185823121,0.5538257701225572,0.76
class,HashCodeBuilderTest,4065,5308,4719,589,-0.12481457936003393,23390,18085,5305,-0.2933370196295273,16567,16567,0,0.0,16353,15784,569,-0.03604916371008615,0.7082941427960667,0.6991449337323643,0.9870827548741474
class,MultiLineToStringStyleTest,1197,1675,1675,0,0.0,8152,7449,703,-0.09437508390387972,6883,6883,0,0.0,6799,6595,204,-0.03093252463987861,0.844332679097154,0.8340284592737979,0.9877960191776841
class,ReflectionToStringBuilderMutateInspectConcurrencyTest,285,346,338,8,-0.023668639053254337,2593,2168,425,-0.1960332103321034,1869,1869,0,0.0,1404,1397,7,-0.005010737294201872,0.720786733513305,0.5414577709217123,0.7512038523274478
class,RecursiveToStringStyleTest,946,1269,1269,0,0.0,6120,5324,796,-0.14951164537941408,4916,4916,0,0.0,4710,4506,204,-0.045272969374167804,0.8032679738562092,0.7696078431372549,0.9580960130187144
class,DiffResultTest,568,722,722,0,0.0,4390,3718,672,-0.18074233458848843,3402,3402,0,0.0,3367,3355,12,-0.0035767511177347,0.7749430523917995,0.7669703872437358,0.9897119341563786
class,JsonToStringStyleTest,1415,1910,1896,14,-0.007383966244725704,11947,9521,2426,-0.2548051675244196,8268,8268,0,0.0,8050,7865,185,-0.023521932612841745,0.6920565832426551,0.673809324516615,0.9736332849540397
class,DiffTest,153,189,189,0,0.0,1235,1027,208,-0.20253164556962022,900,900,0,0.0,871,865,6,-0.006936416184971206,0.728744939271255,0.7052631578947368,0.9677777777777777
class,EqualsBuilderTest,7369,9666,9494,172,-0.01811670528754994,43597,36127,7470,-0.20677055941539568,31895,31895,0,0.0,30956,30692,264,-0.008601589990877123,0.731587035805216,0.7100488565727,0.9705596488477818
class,DefaultToStringStyleTest,885,1213,1213,0,0.0,5460,4849,611,-0.126005361930295,4551,4551,0,0.0,4469,4265,204,-0.04783118405627196,0.8335164835164836,0.8184981684981685,0.9819819819819819
class,StandardToStringStyleTest,921,1251,1251,0,0.0,5832,5161,671,-0.13001356326293356,4794,4794,0,0.0,4723,4519,204,-0.04514273069263108,0.8220164609053497,0.8098422496570644,0.9851898206090947
class,DiffBuilderTest,3055,3800,3800,0,0.0,20249,16720,3529,-0.21106459330143545,15187,15187,0,0.0,14930,14929,1,-6.698372295521615E-5,0.7500123462887056,0.7373203614993333,0.9830776321854218
class,ToStringStyleTest,374,455,455,0,0.0,3157,2673,484,-0.1810699588477367,2337,2337,0,0.0,2179,2179,0,0.0,0.7402597402597403,0.6902122267975926,0.9323919554985024
class,ShortPrefixToStringStyleTest,859,1169,1169,0,0.0,5364,4749,615,-0.12950094756790897,4459,4459,0,0.0,4369,4165,204,-0.048979591836734615,0.831282624906786,0.8145041014168531,0.9798161022650819
class,MultilineRecursiveToStringStyleTest,880,1138,1104,34,-0.030797101449275388,7906,5323,2583,-0.4852526770618073,4427,4427,0,0.0,4422,4219,203,-0.04811566721972027,0.559954464963319,0.559322033898305,0.9988705669753783
class,ArrayUtilsAddTest,5125,7099,7077,22,-0.0031086618623710205,28843,24239,4604,-0.18994182928338632,21665,21665,0,0.0,21630,21538,92,-0.004271520104002224,0.7511354574766841,0.7499219914710675,0.9983844911147012
class,SystemUtilsTest,2506,3403,3396,7,-0.0020612485276796377,21436,19235,2201,-0.11442682609825838,17043,17043,0,0.0,16783,16775,8,-4.769001490312341E-4,0.7950643776824035,0.7829352491136407,0.984744469870328
class,ObjectUtilsTest,3060,4051,4049,2,-4.939491232403004E-4,27738,21298,6440,-0.3023758099352052,18949,18949,0,0.0,17878,17829,49,-0.002748331370239443,0.6831422597159131,0.6445309683466725,0.9434798670114518
class,RangeTest,1804,2486,2472,14,-0.005663430420711935,13001,10687,2314,-0.2165247496958922,9505,9505,0,0.0,9424,9382,42,-0.004476657429119513,0.7310976078763172,0.7248673178986231,0.9914781693845345
class,TripleTest,795,964,965,-1,0.0010362694300518616,4425,3991,434,-0.10874467551991973,3585,3585,0,0.0,3557,3555,2,-5.625879043600346E-4,0.8101694915254237,0.8038418079096045,0.992189679218968
class,MutablePairTest,509,672,672,0,0.0,3140,2808,332,-0.11823361823361833,2546,2546,0,0.0,2513,2489,24,-0.009642426677380467,0.810828025477707,0.8003184713375796,0.9870384917517675
class,MutableTripleTest,675,917,917,0,0.0,4318,3889,429,-0.11031113396760084,3574,3574,0,0.0,3539,3497,42,-0.012010294538175481,0.8276980083371931,0.8195924038906901,0.9902070509233352
class,ImmutablePairTest,471,629,629,0,0.0,2968,2663,305,-0.11453248216297407,2419,2419,0,0.0,2393,2369,24,-0.010130856901646279,0.8150269541778976,0.806266846361186,0.9892517569243489
class,ImmutableTripleTest,633,859,861,-2,0.0023228803716608404,4074,3686,388,-0.10526315789473695,3381,3381,0,0.0,3353,3319,34,-0.010244049412473588,0.8298969072164949,0.8230240549828178,0.9917184265010351
class,PairTest,633,770,770,0,0.0,3420,3060,360,-0.11764705882352944,2706,2706,0,0.0,2680,2674,6,-0.002243829468960401,0.7912280701754386,0.783625730994152,0.9903917220990391
class,ValidateTest,6957,9251,9251,0,0.0,63599,50865,12734,-0.25034896294111864,41963,41963,0,0.0,41905,41905,0,0.0,0.6598059717920093,0.6588940077674177,0.9986178299930891
class,CharRangeTest,2129,2884,2884,0,0.0,13842,11744,2098,-0.1786444141689374,10284,10284,0,0.0,10225,10177,48,-0.00471651763781078,0.7429562201993931,0.7386938303713336,0.9942629327110074
class,RandomStringUtilsTest,2690,3614,3540,74,-0.020903954802259817,21213,17507,3706,-0.21168675386988056,15290,15290,0,0.0,14059,13979,80,-0.0057228700193145965,0.7207844246452647,0.6627539716211757,0.9194898626553303
class,CharSetUtilsTest,1880,2558,2558,0,0.0,11546,9763,1783,-0.18262829048448226,8970,8970,0,0.0,8908,8908,0,0.0,0.7768924302788844,0.7715226052312489,0.993088071348941
class,StringUtilsIsTest,848,1193,1193,0,0.0,7219,6690,529,-0.07907324364723478,6066,6066,0,0.0,5994,5994,0,0.0,0.8402825876160133,0.830308907050838,0.9881305637982196
class,LazyInitializerTest,64,67,67,0,0.0,1096,980,116,-0.1183673469387756,881,881,0,0.0,435,435,0,0.0,0.8038321167883211,0.3968978102189781,0.49375709421112374
class,ThresholdCircuitBreakerTest,171,204,198,6,-0.030303030303030276,2292,1929,363,-0.18818040435458783,1829,1829,0,0.0,1371,1295,76,-0.05868725868725866,0.7979930191972077,0.5981675392670157,0.7495899398578458
class,AbstractConcurrentInitializerTest,252,294,288,6,-0.02083333333333326,3363,2713,650,-0.2395871728713601,2366,2366,0,0.0,1264,1258,6,-0.004769475357710551,0.7035385072851621,0.375854891465953,0.5342349957734573
class,TimedSemaphoreTest,1670,2098,2088,10,-0.00478927203065127,17804,14963,2841,-0.18986834191004487,13266,13266,0,0.0,9701,9669,32,-0.003309545971662109,0.7451134576499663,0.5448775556054819,0.7312679029096939
class,EventCountCircuitBreakerTest,1382,1735,1707,28,-0.016403046280023537,14569,12370,2199,-0.17776879547291835,11085,11085,0,0.0,8370,8238,132,-0.016023306627822365,0.7608621044683918,0.5745075159585421,0.7550744248985115
class,CallableBackgroundInitializerTest,226,263,263,0,0.0,2654,2343,311,-0.13273580879214686,2078,2078,0,0.0,1369,1369,0,0.0,0.7829691032403918,0.515825169555388,0.6588065447545717
class,ConstantInitializerTest,344,411,405,6,-0.014814814814814836,3260,2783,477,-0.171397772188286,2460,2460,0,0.0,1718,1695,23,-0.013569321533923207,0.754601226993865,0.5269938650306748,0.6983739837398374
class,BasicThreadFactoryTest,1239,1578,1576,2,-0.0012690355329949554,10314,9012,1302,-0.144474034620506,8144,8144,0,0.0,6844,6806,38,-0.005583308845136692,0.7896063602869886,0.6635640876478572,0.8403732809430255
class,AtomicInitializerTest,40,45,45,0,0.0,536,470,66,-0.1404255319148937,402,402,0,0.0,276,276,0,0.0,0.75,0.5149253731343284,0.6865671641791045
class,BackgroundInitializerTest,887,1098,1086,12,-0.011049723756906049,9953,8554,1399,-0.163549216740706,7390,7390,0,0.0,5484,5456,28,-0.00513196480938416,0.7424897015975083,0.5509896513613985,0.742083897158322
class,AtomicSafeInitializerTest,105,115,115,0,0.0,1754,1557,197,-0.12652536929993574,1393,1393,0,0.0,771,771,0,0.0,0.7941847206385405,0.4395667046750285,0.5534816941852118
class,MultiBackgroundInitializerTest,1180,1457,1447,10,-0.006910850034554272,15232,13246,1986,-0.14993205495998785,11973,11973,0,0.0,7897,7871,26,-0.003303265150552681,0.7860425420168067,0.5184480042016807,0.6595673598930928
class,ConcurrentUtilsTest,1819,2234,2234,0,0.0,19198,16519,2679,-0.16217688722077606,14653,14653,0,0.0,10721,10721,0,0.0,0.7632565892280446,0.5584435878737368,0.7316590459291613
class,CharEncodingTest,282,373,370,3,-0.008108108108108025,2996,2320,676,-0.29137931034482767,2102,2102,0,0.0,2023,2020,3,-0.0014851485148514865,0.7016021361815754,0.6752336448598131,0.9624167459562322
class,CharSequenceUtilsTest,866,1167,1146,21,-0.018324607329842868,6533,4632,1901,-0.41040587219343694,4117,4117,0,0.0,4088,3938,150,-0.03809040121889273,0.6301852135313026,0.6257462115414052,0.9929560359485062
class,HashSetvBitSetTest,883,1062,1004,58,-0.05776892430278879,5310,4102,1208,-0.29449049244271097,3720,3720,0,0.0,3600,3340,260,-0.07784431137724557,0.7005649717514124,0.6779661016949152,0.967741935483871
class,CharUtilsPerfRun,464,591,581,10,-0.01721170395869187,4911,3917,994,-0.25376563696706667,3579,3579,0,0.0,2286,2272,14,-0.0061619718309859906,0.7287721441661577,0.4654856444715944,0.6387259010896899
class,ThreadUtilsTest,1655,2199,2191,8,-0.003651300775901367,13403,11881,1522,-0.12810369497517038,10396,10396,0,0.0,10335,10278,57,-0.005545826036193802,0.7756472431545176,0.7710960232783706,0.9941323585994614
class,ArrayUtilsTest,26475,36147,35811,336,-0.009382591941023755,166969,136068,30901,-0.22709968545139203,122441,122441,0,0.0,121251,120470,781,-0.006482941811239318,0.7333157652019238,0.7261886937096108,0.9902810333140043
class,MutableObjectTest,464,591,591,0,0.0,2846,2480,366,-0.1475806451612902,2230,2230,0,0.0,2194,2176,18,-0.008272058823529438,0.7835558678847505,0.7709065354884048,0.9838565022421525
class,MutableBooleanTest,568,761,760,1,-0.001315789473684159,3973,3497,476,-0.1361166714326565,3144,3144,0,0.0,3095,3070,25,-0.008143322475570036,0.7913415554996225,0.7790083060659452,0.9844147582697201
class,MutableDoubleTest,1228,1639,1638,1,-6.105006105006083E-4,8414,7271,1143,-0.15719983496080325,6504,6504,0,0.0,6467,6448,19,-0.002946650124069583,0.7729973853101972,0.7685999524601854,0.9943111931119312
class,MutableByteTest,1301,1752,1751,1,-5.711022272987254E-4,8008,6885,1123,-0.16310820624546118,6151,6151,0,0.0,6116,6097,19,-0.0031162866983762694,0.7681068931068931,0.7637362637362637,0.9943098683140953
class,MutableShortTest,1281,1732,1731,1,-5.777007510110455E-4,8087,6985,1102,-0.15776664280601294,6183,6183,0,0.0,6147,6128,19,-0.0031005221932114413,0.7645604055892172,0.7601088166192654,0.9941775836972343
class,MutableLongTest,1215,1625,1564,61,-0.03900255754475701,7779,6599,1180,-0.17881497196544927,5948,5948,0,0.0,5913,5794,119,-0.020538488091128793,0.7646227021468055,0.7601234091785577,0.9941156691324815
class,MutableFloatTest,1225,1635,1634,1,-6.11995104039087E-4,8280,7146,1134,-0.15869017632241822,6379,6379,0,0.0,6343,6324,19,-0.003004427577482538,0.7704106280193237,0.7660628019323672,0.9943564822072425
class,MutableIntTest,1214,1624,1623,1,-6.161429451632117E-4,7992,6759,1233,-0.18242343541944073,6014,6014,0,0.0,5816,5779,37,-0.00640249178058494,0.7525025025025025,0.7277277277277278,0.9670768207515796
class,StringUtilsTest,17763,25467,25390,77,-0.0030326900354469277,140219,118449,21770,-0.18379218060093372,107688,107688,0,0.0,106761,106590,171,-0.0016042780748664054,0.767998630713384,0.7613875437708156,0.991391798529084
class,ContextedExceptionTest,454,584,584,0,0.0,3650,3317,333,-0.100391920410009,3029,3029,0,0.0,2988,2988,0,0.0,0.8298630136986301,0.8186301369863014,0.9864641795972268
class,ExceptionUtilsTest,2921,3917,3897,20,-0.005132152938157608,24856,20861,3995,-0.19150568045635397,18705,18705,0,0.0,18308,18250,58,-0.00317808219178084,0.7525345992919215,0.736562600579337,0.9787757284148624
class,AbstractExceptionContextTest,794,1114,1114,0,0.0,6598,6002,596,-0.09930023325558146,5503,5503,0,0.0,5445,5445,0,0.0,0.8340406183692027,0.8252500757805395,0.9894602943848809
class,ContextedRuntimeExceptionTest,465,595,594,1,-0.0016835016835017313,3897,3464,433,-0.125,3169,3169,0,0.0,3121,3113,8,-0.0025698682942498774,0.813189633051065,0.8008724659994868,0.9848532660145156
class,DefaultExceptionContextTest,47,56,56,0,0.0,514,464,50,-0.10775862068965525,420,420,0,0.0,374,374,0,0.0,0.8171206225680934,0.7276264591439688,0.8904761904761904
class,BooleanUtilsTest,4286,5891,5897,-6,0.0010174665083940715,36949,27203,9746,-0.3582693085321471,25207,25207,0,0.0,25145,25163,-18,7.153360092199135E-4,0.6822106146309779,0.6805326260521259,0.9975403657714127
class,StringUtilsStartsEndsWithTest,1027,1483,1483,0,0.0,10720,9145,1575,-0.17222525970475666,8505,8505,0,0.0,8257,8257,0,0.0,0.7933768656716418,0.7702425373134328,0.9708406819517931
class,StringUtilsContainsTest,2623,3653,3649,4,-0.0010961907371882518,21222,18626,2596,-0.13937506711049075,16946,16946,0,0.0,15488,15484,4,-2.5833118057350113E-4,0.7985109791725568,0.7298086890962209,0.9139619969314292
class,SerializationUtilsTest,1761,2184,2176,8,-0.003676470588235281,13444,11186,2258,-0.2018594671911318,9650,9650,0,0.0,9582,9574,8,-8.355964069355348E-4,0.7177923237131806,0.7127343052662898,0.9929533678756477
class,ClassNotFoundSerialization,31,35,35,0,0.0,302,287,15,-0.05226480836236935,267,267,0,0.0,267,266,1,-0.003759398496240518,0.8841059602649006,0.8841059602649006,1.0
class,StringEscapeUtilsTest,2455,3233,3225,8,-0.002480620155038693,26707,21843,4864,-0.22268003479375542,19556,19556,0,0.0,18187,18124,63,-0.003476053851247052,0.7322424832440934,0.6809825139476542,0.9299959091838822
class,StringUtilsSubstringTest,1900,2838,2838,0,0.0,14499,12442,2057,-0.16532711782671594,11316,11316,0,0.0,11154,11154,0,0.0,0.7804676184564453,0.7692944340989034,0.9856839872746553
class,StringUtilsEqualsIndexOfTest,5598,8205,8211,-6,7.3072707343802E-4,39129,34439,4690,-0.1361828159934957,31434,31434,0,0.0,30947,30969,-22,7.103878071620384E-4,0.8033427892356053,0.7908967773262797,0.9845072214799262
class,JavaVersionTest,170,247,247,0,0.0,1474,1275,199,-0.15607843137254895,1159,1159,0,0.0,1098,1092,6,-0.005494505494505475,0.7862957937584804,0.7449118046132972,0.9473684210526315
class,ArrayUtilsRemoveMultipleTest,10332,14672,14496,176,-0.012141280353200834,58076,50769,7307,-0.14392641178672028,46896,46896,0,0.0,46840,46470,370,-0.007962126102861955,0.8074936290378125,0.8065293753013293,0.998805868304333
class,CharSetTest,2769,3813,3811,2,-5.247966413015615E-4,18347,14989,3358,-0.22403095603442535,13337,13337,0,0.0,13280,13190,90,-0.006823351023502733,0.726930833378754,0.723824058429171,0.995726175301792
class,ConversionTest,13489,21102,21004,98,-0.004665777947057803,99401,74044,25357,-0.3424585381664955,70012,70012,0,0.0,67210,67105,105,-0.0015647120184785202,0.704338990553415,0.6761501393346143,0.9599782894360966
class,TypeUtilsTest,5385,7115,7097,18,-0.002536282936451917,36174,30837,5337,-0.17307131043875867,28093,28093,0,0.0,28073,27964,109,-0.003897868688313544,0.7766075081550284,0.7760546248686903,0.99928807888086
class,AAClass,9,15,15,0,0.0,57,51,6,-0.11764705882352944,43,43,0,0.0,43,43,0,0.0,0.7543859649122807,0.7543859649122807,1.0
class,AAAClass,15,19,19,0,0.0,100,95,5,-0.05263157894736836,87,87,0,0.0,87,87,0,0.0,0.87,0.87,1.0
class,AClass,140,156,156,0,0.0,829,711,118,-0.16596343178621664,628,628,0,0.0,628,628,0,0.0,0.7575392038600723,0.7575392038600723,1.0
class,FieldUtilsTest,6668,9202,9202,0,0.0,61274,53619,7655,-0.14276655663104498,47262,47262,0,0.0,47235,47235,0,0.0,0.7713222574011815,0.7708816137350263,0.9994287165164403
class,GenericParent,23,24,24,0,0.0,171,164,7,-0.04268292682926833,145,145,0,0.0,102,102,0,0.0,0.847953216374269,0.5964912280701754,0.7034482758620689
class,AnotherParent,4,5,5,0,0.0,41,40,1,-0.02499999999999991,33,33,0,0.0,28,28,0,0.0,0.8048780487804879,0.6829268292682927,0.8484848484848485
class,PrivatelyShadowedChild,39,41,41,0,0.0,267,212,55,-0.25943396226415105,192,192,0,0.0,187,187,0,0.0,0.7191011235955056,0.700374531835206,0.9739583333333334
class,StaticContainerChild,6,7,7,0,0.0,70,71,-1,0.014084507042253502,64,64,0,0.0,59,59,0,0.0,0.9142857142857143,0.8428571428571429,0.921875
class,Grandchild,6,7,7,0,0.0,59,58,1,-0.01724137931034475,51,51,0,0.0,46,46,0,0.0,0.864406779661017,0.7796610169491526,0.9019607843137255
class,Parent,40,42,38,4,-0.10526315789473695,226,190,36,-0.18947368421052624,172,172,0,0.0,167,159,8,-0.05031446540880502,0.7610619469026548,0.7389380530973452,0.9709302325581395
interface,GenericConsumer,12,15,15,0,0.0,62,63,-1,0.015873015873015928,55,55,0,0.0,55,55,0,0.0,0.8870967741935484,0.8870967741935484,1.0
class,PubliclyShadowedChild,31,31,31,0,0.0,167,153,14,-0.0915032679738561,134,134,0,0.0,129,129,0,0.0,0.8023952095808383,0.7724550898203593,0.9626865671641791
class,GenericTypeHolder,42,35,35,0,0.0,241,235,6,-0.025531914893617058,210,210,0,0.0,176,176,0,0.0,0.8713692946058091,0.7302904564315352,0.8380952380952381
@interface,Annotated,17,23,23,0,0.0,116,115,1,-0.008695652173912993,111,111,0,0.0,111,111,0,0.0,0.9568965517241379,0.9568965517241379,1.0
interface,Foo,16,18,17,1,-0.05882352941176472,96,86,10,-0.11627906976744184,78,78,0,0.0,73,66,7,-0.10606060606060597,0.8125,0.7604166666666666,0.9358974358974359
class,StringParameterizedChild,25,28,28,0,0.0,256,247,9,-0.036437246963562764,220,220,0,0.0,133,133,0,0.0,0.859375,0.51953125,0.6045454545454545
class,PublicChild,14,14,14,0,0.0,92,90,2,-0.022222222222222143,80,80,0,0.0,75,75,0,0.0,0.8695652173913043,0.8152173913043478,0.9375
class,StaticContainer,131,128,128,0,0.0,1147,1035,112,-0.10821256038647342,931,931,0,0.0,801,801,0,0.0,0.8116826503923278,0.6983435047951178,0.8603651987110634
class,AnotherChild,6,7,7,0,0.0,62,61,1,-0.016393442622950838,54,54,0,0.0,49,49,0,0.0,0.8709677419354839,0.7903225806451613,0.9074074074074074
class,Ambig,15,17,17,0,0.0,96,88,8,-0.09090909090909083,74,74,0,0.0,69,69,0,0.0,0.7708333333333334,0.71875,0.9324324324324325
interface,Bar,16,18,17,1,-0.05882352941176472,96,86,10,-0.11627906976744184,78,78,0,0.0,73,66,7,-0.10606060606060597,0.8125,0.7604166666666666,0.9358974358974359
class,InheritanceUtilsTest,217,285,285,0,0.0,1610,1453,157,-0.10805230557467316,1327,1327,0,0.0,1294,1294,0,0.0,0.824223602484472,0.8037267080745342,0.9751318764129616
class,ConstructorUtilsTest,1332,1699,1690,9,-0.005325443786982298,10821,9044,1777,-0.1964838567005749,8222,8222,0,0.0,8189,8027,162,-0.020181886134296834,0.7598188707143517,0.7567692449866001,0.9959863780102165
class,TypeLiteralTest,217,272,272,0,0.0,1169,1114,55,-0.04937163375224407,967,967,0,0.0,967,967,0,0.0,0.8272027373823782,0.8272027373823782,1.0
class,MethodUtilsTest,4484,5861,5846,15,-0.0025658569962367928,35552,30127,5425,-0.18007103262853907,27213,27213,0,0.0,27185,27089,96,-0.0035438738971538264,0.7654421692169217,0.7646545904590459,0.9989710799985301
class,ClassUtilsTest,9186,12596,12590,6,-4.7656870532164497E-4,70140,60454,9686,-0.16022099447513805,55608,55608,0,0.0,55548,55506,42,-7.566749540590667E-4,0.792814371257485,0.7919589392643285,0.9989210185584808
class,CharUtilsTest,1824,2519,2481,38,-0.015316404675534079,12545,10650,1895,-0.17793427230046954,9221,9221,0,0.0,9162,9154,8,-8.73934891850503E-4,0.7350338780390594,0.7303308090872858,0.9936015616527492
class,ArrayUtilsRemoveTest,5318,7291,7223,68,-0.00941437076007201,30704,27126,3578,-0.13190297131902962,24230,24230,0,0.0,24174,24002,172,-0.007166069494208838,0.789147993746743,0.787324127149557,0.997688815517953
class,EventUtilsTest,975,1229,1203,26,-0.021612635078969156,8374,7027,1347,-0.19168919880461077,6352,6352,0,0.0,6336,6182,154,-0.02491103202846978,0.7585383329352758,0.7566276570336756,0.9974811083123426
class,EventListenerSupportTest,1012,1256,1253,3,-0.002394253790901857,9144,7663,1481,-0.1932663447735874,6965,6965,0,0.0,6930,6863,67,-0.009762494535917154,0.7617016622922135,0.7578740157480315,0.9949748743718593
class,EnumUtilsTest,3336,4610,4610,0,0.0,21848,19250,2598,-0.13496103896103895,18013,18013,0,0.0,18008,18002,6,-3.332963004110123E-4,0.8244690589527646,0.8242402050530941,0.9997224226947204
enum,Traffic,8,9,9,0,0.0,38,33,5,-0.1515151515151516,29,29,0,0.0,29,29,0,0.0,0.7631578947368421,0.7631578947368421,1.0
enum,Enum64,130,131,131,0,0.0,351,333,18,-0.054054054054053946,268,268,0,0.0,268,268,0,0.0,0.7635327635327636,0.7635327635327636,1.0
enum,TooMany,132,133,133,0,0.0,200,248,-48,0.19354838709677424,182,182,0,0.0,182,182,0,0.0,0.91,0.91,1.0
class,RandomUtilsTest,669,800,800,0,0.0,5670,4926,744,-0.15103532277710108,4263,4263,0,0.0,3547,3547,0,0.0,0.7518518518518519,0.6255731922398589,0.8320431620924231
class,LocaleUtilsTest,2116,2676,2664,12,-0.0045045045045044585,21145,16214,4931,-0.30411989638583936,13830,13830,0,0.0,12039,11998,41,-0.003417236206034291,0.6540553322298416,0.569354457318515,0.8704989154013015
class,FastDateParser_TimeZoneStrategyTest,182,248,234,14,-0.05982905982905984,1668,1145,523,-0.456768558951965,1011,1011,0,0.0,1011,965,46,-0.04766839378238341,0.6061151079136691,0.6061151079136691,1.0
class,DateUtilsTest,8773,12231,12153,78,-0.006418168353492959,77837,61066,16771,-0.2746372776995383,55687,55687,0,0.0,54234,54030,204,-0.0037756801776791526,0.7154309647083007,0.6967637498875856,0.9739077343006447
class,FastDatePrinterTest,2103,2728,2692,36,-0.013372956909361022,15188,12827,2361,-0.1840648631792312,11828,11828,0,0.0,11058,10790,268,-0.02483781278962005,0.7787727153015539,0.7280747958914933,0.9349002367264119
class,DateFormatUtilsTest,1211,1645,1598,47,-0.02941176470588225,10745,8000,2745,-0.3431249999999999,7616,7616,0,0.0,7396,7129,267,-0.03745265815682419,0.7087947882736156,0.6883201489064681,0.9711134453781513
class,FastDatePrinterTimeZonesTest,158,179,177,2,-0.011299435028248483,1050,915,135,-0.14754098360655732,844,844,0,0.0,844,818,26,-0.0317848410757946,0.8038095238095239,0.8038095238095239,1.0
class,FastDateFormatTest,1555,2020,2013,7,-0.003477396920019915,13089,10778,2311,-0.2144182594173316,9945,9945,0,0.0,9760,9670,90,-0.009307135470527417,0.7597983039193216,0.7456642982657193,0.9813976872800402
class,DurationFormatUtilsTest,4134,5919,5785,134,-0.023163353500432082,31723,24731,6992,-0.28272208968501067,22921,22921,0,0.0,22773,22614,159,-0.007031042716901137,0.7225356996500961,0.7178703149134698,0.9935430391344182
class,FastDateParserTest,3707,4791,4738,53,-0.011186154495567813,26268,21661,4607,-0.21268639490328245,19516,19516,0,0.0,18955,18666,289,-0.015482695810564717,0.7429572102938937,0.7216004263742957,0.9712543554006968
class,DateUtilsFragmentTest,2878,3654,3546,108,-0.030456852791878264,23227,19646,3581,-0.18227629033900028,17464,17464,0,0.0,17464,17356,108,-0.0062226319428440036,0.751883583760279,0.751883583760279,1.0
class,FastDateParserSDFTest,934,1304,1278,26,-0.020344287949921824,9145,5463,3682,-0.6739886509244004,4937,4937,0,0.0,4887,4841,46,-0.009502168973352543,0.5398578458173865,0.5343903772553308,0.9898723921409763
class,FastDateFormat_PrinterTest,36,38,38,0,0.0,347,310,37,-0.11935483870967745,304,304,0,0.0,237,213,24,-0.11267605633802824,0.8760806916426513,0.6829971181556196,0.7796052631578947
class,StopWatchTest,1029,1336,1336,0,0.0,9109,7710,1399,-0.18145265888456552,6296,6296,0,0.0,5764,5738,26,-0.00453119553851522,0.6911845427599078,0.6327807662751125,0.9155019059720457
class,FastDateParser_MoreOrLessTest,512,681,681,0,0.0,3869,3385,484,-0.142983751846381,3089,3089,0,0.0,3089,3089,0,0.0,0.7983975187386921,0.7983975187386921,1.0
class,WeekYearTest,305,434,434,0,0.0,2308,1741,567,-0.3256748994830556,1624,1624,0,0.0,1624,1624,0,0.0,0.7036395147313691,0.7036395147313691,1.0
class,DateUtilsRoundingTest,2620,3253,3235,18,-0.005564142194744992,33722,29049,4673,-0.1608661227580983,26899,26899,0,0.0,21335,21163,172,-0.00812739214667113,0.7976691773916138,0.6326730324417295,0.7931521617904012
class,FastDateFormat_ParserTest,36,38,38,0,0.0,344,307,37,-0.12052117263843654,301,301,0,0.0,234,210,24,-0.11428571428571432,0.875,0.6802325581395349,0.7774086378737541
class,CharEncoding,99,97,95,2,-0.021052631578947434,3249,2865,384,-0.13403141361256554,2679,2679,0,0.0,482,480,2,-0.004166666666666652,0.8245614035087719,0.14835333948907356,0.1799178798058977
class,StrTokenizer,2094,2541,2433,108,-0.04438964241676935,37176,28836,8340,-0.28922180607573855,25972,25972,0,0.0,10440,10098,342,-0.033868092691622165,0.6986227673768023,0.28082633957391867,0.40197135376559373
class,StrSubstitutor,2472,2982,2839,143,-0.050369848538217576,50654,39970,10684,-0.26730047535651735,37297,37297,0,0.0,13117,12727,390,-0.0306435137895813,0.7363090772693174,0.25895289611876654,0.3516904844893691
class,ExtendedMessageFormat,1555,1991,1907,84,-0.04404824331410584,18219,13666,4553,-0.33316259329723397,12729,12729,0,0.0,7558,7256,302,-0.04162072767364933,0.6986662275646304,0.41484164882814645,0.5937622751198052
class,WordUtils,983,1270,1209,61,-0.05045492142266328,23021,17838,5183,-0.29055947976230523,15956,15956,0,0.0,4432,4259,173,-0.0406198638177977,0.6931062942530732,0.19251987315928934,0.27776385058912006
class,StrBuilder,7293,9033,8547,486,-0.05686205686205681,106426,84176,22250,-0.26432712412088955,74619,74619,0,0.0,31104,29577,1527,-0.05162795415356536,0.7011350609813392,0.29225941029447694,0.41683753467615486
class,CharSequenceTranslator,325,411,401,10,-0.02493765586034913,4550,3586,964,-0.26882320133853876,3176,3176,0,0.0,1495,1443,52,-0.03603603603603611,0.6980219780219781,0.32857142857142857,0.47071788413098237
class,EntityArrays,1136,1969,1969,0,0.0,24325,8796,15529,-1.7654615734424737,8458,8458,0,0.0,6944,6916,28,-0.004048582995951344,0.3477081192189106,0.2854676258992806,0.8209978718373138
class,UnicodeUnpairedSurrogateRemover,42,46,37,9,-0.2432432432432432,654,444,210,-0.472972972972973,428,428,0,0.0,267,244,23,-0.09426229508196715,0.654434250764526,0.40825688073394495,0.6238317757009346
class,AggregateTranslator,86,97,95,2,-0.021052631578947434,1168,1009,159,-0.15758176412289404,938,938,0,0.0,502,461,41,-0.08893709327548804,0.803082191780822,0.4297945205479452,0.535181236673774
class,JavaUnicodeEscaper,147,170,170,0,0.0,3221,2730,491,-0.17985347985347988,2479,2479,0,0.0,854,854,0,0.0,0.7696367587705681,0.26513505122632725,0.3444937474788221
class,OctalUnescaper,205,254,251,3,-0.01195219123505975,2234,1830,404,-0.22076502732240444,1646,1646,0,0.0,882,868,14,-0.016129032258064502,0.7367949865711728,0.39480752014324083,0.5358444714459295
class,LookupTranslator,269,323,311,12,-0.03858520900321549,2321,1700,621,-0.36529411764705877,1480,1480,0,0.0,1082,1050,32,-0.030476190476190546,0.6376561826798793,0.46617837139164153,0.731081081081081
class,UnicodeEscaper,280,333,327,6,-0.0183486238532109,3994,3460,534,-0.15433526011560694,3035,3035,0,0.0,1361,1355,6,-0.0044280442804427445,0.7598898347521282,0.3407611417125688,0.4484349258649094
class,NumericEntityEscaper,218,253,249,4,-0.016064257028112428,3424,3071,353,-0.11494627157277759,2732,2732,0,0.0,1162,1158,4,-0.003454231433505983,0.7978971962616822,0.33936915887850466,0.4253294289897511
class,UnicodeUnescaper,184,237,229,8,-0.03493449781659397,1604,1189,415,-0.34903280067283426,1039,1039,0,0.0,856,842,14,-0.016627078384798155,0.6477556109725686,0.5336658354114713,0.8238691049085659
class,NumericEntityUnescaper,395,505,441,64,-0.14512471655328807,4116,2755,1361,-0.49401088929219594,2588,2588,0,0.0,1736,1557,179,-0.11496467565831736,0.6287657920310982,0.4217687074829932,0.6707882534775889
class,CodePointTranslator,71,75,69,6,-0.08695652173913038,1088,974,114,-0.11704312114989723,919,919,0,0.0,390,358,32,-0.0893854748603351,0.8446691176470589,0.3584558823529412,0.4243743199129489
class,StrLookup,245,267,252,15,-0.059523809523809534,5476,4273,1203,-0.2815352211560964,3885,3885,0,0.0,1033,997,36,-0.03610832497492478,0.7094594594594594,0.18864134404674945,0.2658944658944659
class,CompositeFormat,157,152,152,0,0.0,2748,2374,374,-0.1575400168491996,2141,2141,0,0.0,752,740,12,-0.016216216216216273,0.7791120815138283,0.27365356622998543,0.3512377393741242
class,StrMatcher,746,851,796,55,-0.06909547738693478,14271,11650,2621,-0.2249785407725322,10478,10478,0,0.0,3576,3422,154,-0.04500292226767977,0.734216242730012,0.25057809543830145,0.3412865050582172
interface,FormatFactory,21,18,18,0,0.0,581,488,93,-0.19057377049180335,452,452,0,0.0,93,88,5,-0.05681818181818188,0.7779690189328744,0.16006884681583478,0.20575221238938052
class,FormattableUtils,322,379,373,6,-0.01608579088471851,5601,4830,771,-0.15962732919254652,4533,4533,0,0.0,1641,1507,134,-0.0889183808891838,0.8093197643277986,0.2929833958221746,0.3620119126406353
class,CharUtils,698,844,786,58,-0.07379134860050884,17963,14196,3767,-0.26535643843336154,13042,13042,0,0.0,3163,2955,208,-0.0703891708967852,0.7260479875299226,0.17608417302232365,0.24252415273731023
class,NumberUtils,3601,4575,4223,352,-0.08335306654037411,56642,39062,17580,-0.45005376068813674,35631,35631,0,0.0,13797,12720,1077,-0.08466981132075468,0.629056177394866,0.24358250061791603,0.3872189946956302
class,Fraction,2374,2929,2741,188,-0.06858810653046343,34173,25555,8618,-0.3372334181177852,23096,23096,0,0.0,10898,10337,561,-0.05427106510593016,0.6758552073274222,0.31890673923858015,0.4718565985452026
class,IEEE754rUtils,516,693,625,68,-0.10880000000000001,7454,5793,1661,-0.28672535819092015,5265,5265,0,0.0,2080,1896,184,-0.09704641350210963,0.7063321706466327,0.2790448081566944,0.3950617283950617
class,StringEscapeUtils,1292,1683,1644,39,-0.02372262773722622,30513,23689,6824,-0.28806619105914133,22126,22126,0,0.0,7871,7712,159,-0.020617219917012486,0.725133549634582,0.25795562547111067,0.35573533399620355
class,ArrayUtils,17819,21859,20518,1341,-0.0653572472950581,316083,256873,59210,-0.2305030112156592,232968,232968,0,0.0,73657,69707,3950,-0.05666575810176888,0.7370469148926073,0.2330305647567253,0.31616788571821025
class,LocaleUtils,961,1251,1197,54,-0.04511278195488733,12459,8871,3588,-0.40446398376733184,8525,8525,0,0.0,4557,4219,338,-0.08011377103579043,0.6842443213741071,0.36575969178906814,0.5345454545454545
class,CharSet,552,681,660,21,-0.031818181818181746,8918,6732,2186,-0.3247177658942364,6063,6063,0,0.0,2216,2120,96,-0.04528301886792452,0.6798609553711594,0.24848620766988114,0.36549562922645557
class,ObjectUtils,1542,1895,1800,95,-0.05277777777777781,37687,29424,8263,-0.2808251767264818,26822,26822,0,0.0,6970,6480,490,-0.07561728395061729,0.7117043012179266,0.1849444105394433,0.25986130788158973
class,RecursiveToStringStyle,140,176,167,9,-0.05389221556886237,2137,1772,365,-0.20598194130925518,1661,1661,0,0.0,765,710,55,-0.07746478873239426,0.7772578380907814,0.35797847449695835,0.4605659241420831
class,HashCodeBuilder,1425,1717,1555,162,-0.10418006430868165,32326,24205,8121,-0.33550919231563725,22367,22367,0,0.0,7054,6587,467,-0.07089722180051616,0.6919198168656808,0.21821444038854174,0.3153753297268297
class,ToStringStyle,5419,6473,6188,285,-0.04605688429217847,87808,67744,20064,-0.2961738308927728,61801,61801,0,0.0,29547,27732,1815,-0.06544785807009945,0.7038196975218659,0.3364955357142857,0.47809905988576235
@interface,HashCodeExclude,14,17,17,0,0.0,287,278,9,-0.03237410071942448,261,261,0,0.0,96,96,0,0.0,0.9094076655052264,0.3344947735191638,0.367816091954023
class,DiffBuilder,2180,2711,2513,198,-0.07879029048945485,28765,19581,9184,-0.4690260967264184,17912,17912,0,0.0,10494,10040,454,-0.04521912350597601,0.6227011993742395,0.3648183556405354,0.5858642251004913
interface,Builder,11,13,13,0,0.0,2150,1730,420,-0.24277456647398843,1624,1624,0,0.0,39,39,0,0.0,0.7553488372093023,0.01813953488372093,0.02401477832512315
class,IDKey,96,102,93,9,-0.09677419354838701,1554,924,630,-0.6818181818181819,828,828,0,0.0,378,359,19,-0.052924791086351064,0.5328185328185329,0.24324324324324326,0.45652173913043476
interface,Diffable,15,15,15,0,0.0,1400,1313,87,-0.06626047220106623,1234,1234,0,0.0,53,53,0,0.0,0.8814285714285715,0.03785714285714286,0.04294975688816856
@interface,ToStringExclude,14,17,17,0,0.0,235,230,5,-0.021739130434782705,214,214,0,0.0,96,96,0,0.0,0.9106382978723404,0.4085106382978723,0.4485981308411215
class,DiffResult,312,362,341,21,-0.061583577712609916,5423,4317,1106,-0.25619643270789894,3930,3930,0,0.0,1519,1462,57,-0.03898768809849518,0.7246911303706436,0.28010326387608336,0.38651399491094146
class,CompareToBuilder,2198,2756,2558,198,-0.07740422204847541,36946,29089,7857,-0.2701021004503421,26493,26493,0,0.0,8458,8051,407,-0.05055272636939501,0.7170735668272614,0.22892870676121907,0.31925414260370666
class,MultilineRecursiveToStringStyle,654,756,747,9,-0.012048192771084265,5817,4969,848,-0.17065808009659889,4420,4420,0,0.0,3265,3134,131,-0.04179961710274416,0.7598418428743339,0.5612858861956335,0.7386877828054299
class,ReflectionToStringBuilder,965,1171,1111,60,-0.054005400540054094,23992,19045,4947,-0.25975321606720914,17740,17740,0,0.0,5329,5016,313,-0.062400318979266345,0.7394131377125709,0.22211570523507837,0.3003945885005637
class,Diff,140,157,157,0,0.0,2220,1782,438,-0.2457912457912459,1580,1580,0,0.0,674,674,0,0.0,0.7117117117117117,0.3036036036036036,0.42658227848101266
class,StandardToStringStyle,585,685,681,4,-0.005873715124816492,17165,11491,5674,-0.4937777391001654,10368,10368,0,0.0,4030,4022,8,-0.0019890601690701892,0.6040198077483251,0.2347800757355083,0.388695987654321
class,ToStringBuilder,1668,1933,1917,16,-0.008346374543557689,35723,29424,6299,-0.21407694399129973,26507,26507,0,0.0,8211,8112,99,-0.012204142011834396,0.742014948352602,0.22985191613246367,0.30976723129739314
@interface,EqualsExclude,14,17,17,0,0.0,281,272,9,-0.03308823529411775,255,255,0,0.0,94,94,0,0.0,0.9074733096085409,0.33451957295373663,0.3686274509803922
class,EqualsBuilder,2227,2793,2492,301,-0.1207865168539326,32487,23915,8572,-0.35843612795316737,21904,21904,0,0.0,8849,8213,636,-0.07743820771946908,0.6742389263397667,0.2723858774278942,0.40399013878743606
class,RandomStringUtils,813,1023,974,49,-0.0503080082135523,17333,14289,3044,-0.21303100286934007,13221,13221,0,0.0,3951,3815,136,-0.0356487549148099,0.7627646685513183,0.22794669128252468,0.2988427501701838
class,StringUtils,14442,18202,16941,1261,-0.07443480314031059,352746,275876,76870,-0.27863967869622575,249476,249476,0,0.0,61220,57475,3745,-0.0651587646802958,0.7072397702596203,0.173552641277293,0.24539434655036957
class,CharSequenceUtils,523,657,609,48,-0.07881773399014769,7991,5370,2621,-0.48808193668528865,4856,4856,0,0.0,2186,2047,139,-0.06790425012212986,0.6076836440996121,0.27355775247153047,0.45016474464579903
class,ClassPathUtils,174,222,218,4,-0.0183486238532109,5327,4804,523,-0.10886761032472947,4524,4524,0,0.0,1265,1257,8,-0.006364359586316537,0.8492584944621738,0.2374694950253426,0.27961980548187443
class,Pair,313,387,384,3,-0.0078125,5364,4441,923,-0.20783607295654138,4049,4049,0,0.0,1252,1235,17,-0.013765182186234792,0.7548471290082028,0.23340790454884414,0.3092121511484317
class,ImmutableTriple,175,168,164,4,-0.024390243902439046,2435,2127,308,-0.14480488951574988,1860,1860,0,0.0,573,565,8,-0.014159292035398341,0.7638603696098563,0.2353182751540041,0.30806451612903224
class,Triple,318,408,407,1,-0.002457002457002533,4918,4145,773,-0.1864897466827502,3741,3741,0,0.0,1284,1275,9,-0.007058823529411784,0.7606750711671411,0.261081740544937,0.34322373696872494
class,ImmutablePair,147,143,139,4,-0.02877697841726623,2416,2092,324,-0.15487571701720837,1854,1854,0,0.0,533,525,8,-0.015238095238095273,0.7673841059602649,0.22061258278145696,0.28748651564185546
class,MutablePair,194,192,184,8,-0.04347826086956519,2535,2122,413,-0.19462770970782284,1832,1832,0,0.0,655,629,26,-0.04133545310015907,0.7226824457593688,0.2583826429980276,0.35753275109170307
class,MutableTriple,228,222,214,8,-0.03738317757009346,2818,2406,412,-0.17123857024106393,2056,2056,0,0.0,735,719,16,-0.022253129346314404,0.7295954577714692,0.2608232789212207,0.35749027237354086
class,EnumUtils,894,1037,1025,12,-0.011707317073170742,13080,11756,1324,-0.1126233412725417,10591,10591,0,0.0,3962,3874,88,-0.02271553949406302,0.8097094801223241,0.3029051987767584,0.37409120951751484
class,Conversion,4862,6000,5691,309,-0.054296257248286794,60901,48351,12550,-0.2595602986494592,44475,44475,0,0.0,19847,19243,604,-0.031388037208335495,0.7302835749823484,0.32588955846373624,0.44625070264193367
class,SerializationUtils,635,793,773,20,-0.025873221216041298,12374,9742,2632,-0.27017039622254146,8732,8732,0,0.0,3531,3416,115,-0.03366510538641676,0.7056731857119767,0.2853563924357524,0.4043747136967476
class,Validate,3353,4027,3885,142,-0.03655083655083646,88549,75041,13508,-0.18000826215002474,69354,69354,0,0.0,18135,17917,218,-0.012167215493665173,0.7832273656393636,0.204801861116444,0.26148455748767196
class,EventCountCircuitBreaker,817,924,898,26,-0.028953229398663627,22290,19459,2831,-0.14548537951590523,18133,18133,0,0.0,5161,4968,193,-0.03884863123993565,0.8135038133692238,0.23153880663974877,0.2846192025588706
class,ConcurrentException,57,69,65,4,-0.06153846153846154,1666,1511,155,-0.10258107213765721,1397,1397,0,0.0,374,366,8,-0.021857923497267784,0.8385354141656662,0.22448979591836735,0.2677165354330709
class,ThresholdCircuitBreaker,139,157,149,8,-0.05369127516778516,2658,2261,397,-0.1755860238832374,2026,2026,0,0.0,712,700,12,-0.017142857142857126,0.7622272385252069,0.26787057938299474,0.351431391905232
class,LazyInitializer,72,80,76,4,-0.05263157894736836,3882,3360,522,-0.15535714285714275,3192,3192,0,0.0,342,308,34,-0.11038961038961048,0.8222565687789799,0.08809891808346214,0.10714285714285714
class,ConcurrentRuntimeException,58,70,66,4,-0.06060606060606055,1804,1636,168,-0.10268948655256716,1519,1519,0,0.0,410,402,8,-0.01990049751243772,0.8420177383592018,0.22727272727272727,0.26991441737985516
interface,CircuitBreaker,34,40,40,0,0.0,3173,2915,258,-0.08850771869639784,2764,2764,0,0.0,162,162,0,0.0,0.8710999054522534,0.0510557831705011,0.05861070911722142
class,CallableBackgroundInitializer,110,117,115,2,-0.017391304347825987,3995,3636,359,-0.09873487348734877,3367,3367,0,0.0,549,541,8,-0.014787430683918634,0.8428035043804756,0.1374217772215269,0.16305316305316306
class,AbstractCircuitBreaker,242,270,267,3,-0.011235955056179803,3900,3232,668,-0.20668316831683176,2937,2937,0,0.0,1304,1259,45,-0.03574265289912626,0.7530769230769231,0.3343589743589744,0.44399046646237655
class,ConcurrentUtils,607,687,666,21,-0.03153153153153143,14237,12007,2230,-0.1857249937536436,11019,11019,0,0.0,2778,2649,129,-0.04869762174405445,0.7739692350916626,0.19512537753740256,0.25210999183228966
class,CircuitBreakingException,59,69,65,4,-0.06153846153846154,1340,1203,137,-0.11388196176226106,1077,1077,0,0.0,384,376,8,-0.02127659574468077,0.8037313432835821,0.2865671641791045,0.3565459610027855
class,MultiBackgroundInitializer,554,641,623,18,-0.028892455858748,13979,11951,2028,-0.1696929127269684,11021,11021,0,0.0,2962,2901,61,-0.021027231988969275,0.7883968810358395,0.21188926246512627,0.26875964068596314
interface,ConcurrentInitializer,13,15,15,0,0.0,1425,1321,104,-0.07872823618470859,1262,1262,0,0.0,77,77,0,0.0,0.8856140350877193,0.05403508771929825,0.061014263074484945
class,BackgroundInitializer,349,404,391,13,-0.03324808184143224,12243,10610,1633,-0.15391140433553252,9773,9773,0,0.0,2030,2018,12,-0.005946481665014769,0.7982520624030058,0.16580903373356204,0.20771513353115728
class,BasicThreadFactory,521,562,541,21,-0.038817005545286554,13076,11251,1825,-0.1622078037507777,10266,10266,0,0.0,2890,2804,86,-0.030670470756062773,0.7851024778219639,0.2210156011012542,0.28151178647964153
class,AtomicInitializer,83,97,95,2,-0.021052631578947434,3892,3501,391,-0.11168237646386747,3341,3341,0,0.0,401,369,32,-0.08672086720867211,0.8584275436793423,0.10303186022610483,0.12002394492666867
class,AtomicSafeInitializer,103,114,110,4,-0.036363636363636376,3125,2837,288,-0.10151568558336277,2686,2686,0,0.0,507,488,19,-0.03893442622950816,0.85952,0.16224,0.18875651526433357
class,TimedSemaphore,472,542,527,15,-0.028462998102466885,15025,13069,1956,-0.1496671512740071,12045,12045,0,0.0,2622,2604,18,-0.00691244239631339,0.8016638935108154,0.17450915141430948,0.21768368617683687
class,ConstantInitializer,170,201,197,4,-0.020304568527918843,3660,3171,489,-0.15421002838221387,2919,2919,0,0.0,851,839,12,-0.014302741358760418,0.7975409836065573,0.23251366120218578,0.29153819801301817
enum,JavaVersion,398,542,502,40,-0.07968127490039834,5454,4071,1383,-0.339719970523213,3743,3743,0,0.0,1775,1692,83,-0.04905437352245867,0.6862852951961863,0.32544921158782547,0.4742185412770505
interface,Mutable,19,20,20,0,0.0,1022,893,129,-0.14445688689809622,827,827,0,0.0,65,65,0,0.0,0.8091976516634051,0.06360078277886497,0.07859733978234583
class,MutableDouble,555,619,599,20,-0.03338898163606019,12632,10317,2315,-0.22438693418629452,9323,9323,0,0.0,2490,2414,76,-0.0314830157415078,0.7380462317922736,0.19711842938568713,0.2670814115628017
class,MutableBoolean,280,318,294,24,-0.08163265306122458,5262,3992,1270,-0.31813627254509025,3574,3574,0,0.0,1290,1221,69,-0.05651105651105648,0.6792094260737362,0.2451539338654504,0.3609401231113598
class,MutableShort,519,571,544,27,-0.049632352941176405,10978,8903,2075,-0.2330675053352802,8018,8018,0,0.0,2286,2193,93,-0.04240766073871405,0.7303698305702314,0.20823465112042266,0.2851085058618109
class,MutableInt,508,559,532,27,-0.050751879699248104,10672,8618,2054,-0.2383383615688095,7756,7756,0,0.0,2175,2082,93,-0.04466858789625361,0.7267616191904048,0.20380434782608695,0.2804280556988138
class,MutableObject,180,207,191,16,-0.08376963350785349,2867,2176,691,-0.3175551470588236,1924,1924,0,0.0,736,696,40,-0.05747126436781613,0.6710847575863271,0.25671433554237877,0.38253638253638256
class,MutableByte,519,571,544,27,-0.049632352941176405,10899,8823,2076,-0.23529411764705888,7939,7939,0,0.0,2241,2148,93,-0.0432960893854748,0.7284154509588036,0.2056151940545004,0.28227736490741906
class,MutableLong,518,573,546,27,-0.0494505494505495,10711,8655,2056,-0.23755054881571347,7789,7789,0,0.0,2218,2125,93,-0.04376470588235293,0.727196340210998,0.2070768368966483,0.2847605597637694
class,MutableFloat,540,601,581,20,-0.03442340791738374,12557,10239,2318,-0.22638929582967093,9246,9246,0,0.0,2390,2314,76,-0.032843560933448535,0.7363223699928327,0.190332085689257,0.25849015790612156
class,BitField,348,397,395,2,-0.005063291139240533,9645,8354,1291,-0.1545367488628202,7598,7598,0,0.0,1539,1537,2,-0.0013012361743656164,0.7877656817003629,0.15956454121306377,0.2025533035009213
class,SerializationException,63,73,69,4,-0.05797101449275366,1615,1414,201,-0.14214992927864212,1269,1269,0,0.0,382,374,8,-0.021390374331550888,0.7857585139318886,0.23653250773993809,0.30102442868400314
class,ClassUtils,3562,4479,4133,346,-0.08371642874425356,52351,40706,11645,-0.2860757627868127,38265,38265,0,0.0,16768,15360,1408,-0.09166666666666656,0.730931596340089,0.3202995167236538,0.43820723899124525
class,Range,941,1110,1006,104,-0.1033797216699801,16867,13633,3234,-0.2372185139000953,12667,12667,0,0.0,4293,3961,332,-0.08381721787427421,0.7509930633781942,0.25452066164700304,0.3389121338912134
class,ContextedRuntimeException,315,342,336,6,-0.017857142857142794,7996,7016,980,-0.13968072976054735,6441,6441,0,0.0,1929,1919,10,-0.005211047420531578,0.8055277638819409,0.2412456228114057,0.29948765719608755
class,ContextedException,315,342,336,6,-0.017857142857142794,7879,6900,979,-0.14188405797101455,6325,6325,0,0.0,1866,1856,10,-0.005387931034482651,0.8027668485848458,0.23683208529001143,0.2950197628458498
class,CloneFailedException,56,63,63,0,0.0,1200,922,278,-0.30151843817787416,814,814,0,0.0,338,338,0,0.0,0.6783333333333333,0.2816666666666667,0.4152334152334152
class,DefaultExceptionContext,499,592,569,23,-0.040421792618629215,4232,3476,756,-0.2174913693901035,2944,2944,0,0.0,2236,2150,86,-0.040000000000000036,0.6956521739130435,0.5283553875236295,0.7595108695652174
interface,ExceptionContext,81,69,69,0,0.0,2871,2607,264,-0.10126582278481022,2391,2391,0,0.0,371,371,0,0.0,0.832810867293626,0.12922326715430163,0.15516520284399832
class,ExceptionUtils,1551,1846,1756,90,-0.051252847380409916,32872,26135,6737,-0.2577769274918691,24711,24711,0,0.0,7701,7008,693,-0.09888698630136994,0.7517339985397907,0.2342723290338282,0.3116425883209907
class,SystemUtils,1572,1623,1591,32,-0.020113136392206243,56475,46275,10200,-0.220421393841167,42710,42710,0,0.0,10326,10232,94,-0.009186864738076617,0.7562638335546702,0.18284196547144754,0.24177007726527744
class,ThreadUtils,959,1141,1081,60,-0.05550416281221082,18652,15208,3444,-0.22645975802209373,14451,14451,0,0.0,5494,5053,441,-0.08727488620621404,0.7747694617199228,0.2945528629637572,0.3801813023320185
class,AnnotationUtils,1217,1620,1429,191,-0.13365990202939115,12790,10042,2748,-0.2736506671977694,9130,9130,0,0.0,5503,4975,528,-0.10613065326633175,0.7138389366692729,0.4302580140734949,0.6027382256297918
class,NotImplementedException,155,167,167,0,0.0,3312,2945,367,-0.1246179966044143,2666,2666,0,0.0,784,784,0,0.0,0.8049516908212561,0.23671497584541062,0.2940735183795949
class,CharSetUtils,521,669,614,55,-0.0895765472312704,8856,6626,2230,-0.3365529731361303,5887,5887,0,0.0,2093,1924,169,-0.08783783783783794,0.664747064137308,0.23633694670280037,0.3555291319857313
class,MethodUtils,2199,2716,2637,79,-0.029958285930982154,37397,30074,7323,-0.2434993682250448,28137,28137,0,0.0,12321,11657,664,-0.05696148237110754,0.7523865550712624,0.329464930342006,0.4378931655826847
class,TypeUtils,5422,6712,6433,279,-0.04337012280429042,68630,48285,20345,-0.4213523868696283,44442,44442,0,0.0,27580,25949,1631,-0.0628540598867009,0.6475593763660207,0.4018650735829812,0.620584132127267
class,InheritanceUtils,97,126,116,10,-0.0862068965517242,1412,1198,214,-0.1786310517529215,1071,1071,0,0.0,373,360,13,-0.036111111111111205,0.7584985835694051,0.26416430594900847,0.34827264239028943
class,MemberUtils,1017,1248,1202,46,-0.038269550748752046,12013,9394,2619,-0.27879497551628707,8540,8540,0,0.0,5021,4792,229,-0.047787979966610994,0.7108965287605095,0.4179638724714892,0.5879391100702576
class,FieldUtils,1779,2095,2061,34,-0.016496846191169423,35752,27360,8392,-0.3067251461988305,25127,25127,0,0.0,9894,9488,406,-0.04279089376053968,0.7028138285970016,0.27673976281047213,0.39375970072034067
class,ConstructorUtils,614,745,721,24,-0.03328710124826628,13006,10777,2229,-0.20682935881970854,10055,10055,0,0.0,3293,3164,129,-0.04077117572692801,0.773104720898047,0.2531908349992311,0.3274987568373943
interface,Typed,11,13,13,0,0.0,227,206,21,-0.10194174757281549,172,172,0,0.0,42,42,0,0.0,0.7577092511013216,0.18502202643171806,0.2441860465116279
class,TypeLiteral,187,226,223,3,-0.013452914798206317,3292,2934,358,-0.12201772324471705,2718,2718,0,0.0,913,897,16,-0.01783723522853964,0.8256379100850547,0.2773390036452005,0.3359087564385578
class,CharRange,708,825,770,55,-0.0714285714285714,10191,7641,2550,-0.3337259521005105,6653,6653,0,0.0,2931,2785,146,-0.05242369838420102,0.6528309292513002,0.2876067118045334,0.4405531339245453
class,RandomUtils,321,408,380,28,-0.0736842105263158,6428,5139,1289,-0.2508270091457483,4694,4694,0,0.0,2140,2066,74,-0.03581800580832528,0.7302426882389546,0.3329184816428127,0.455901150404772
class,BooleanUtils,1844,2299,2146,153,-0.07129543336439892,41682,32342,9340,-0.28878857213530384,29308,29308,0,0.0,9007,8526,481,-0.05641566971616241,0.7031332469651168,0.21608847943956624,0.3073222328374505
class,EventListenerSupport,573,659,651,8,-0.01228878648233489,11436,9168,2268,-0.2473821989528795,8543,8543,0,0.0,3357,3233,124,-0.03835446953294164,0.747026932493879,0.2935466946484785,0.3929532950953997
class,EventUtils,348,428,421,7,-0.016627078384798155,4777,4114,663,-0.16115702479338845,3707,3707,0,0.0,2129,2083,46,-0.022083533365338415,0.7760100481473728,0.4456772032656479,0.574318856217966
class,CalendarReflection,210,267,254,13,-0.051181102362204633,2722,2074,648,-0.31243972999035674,1916,1916,0,0.0,1118,1017,101,-0.09931170108161269,0.7038941954445261,0.41072740631888316,0.5835073068893528
class,FastDateFormat,1116,1202,1201,1,-8.326394671107629E-4,23073,18862,4211,-0.2232531014738628,17562,17562,0,0.0,5787,5437,350,-0.06437373551590952,0.7611493953972175,0.25081263814848526,0.32951827810044415
class,StopWatch,702,851,819,32,-0.039072039072039155,14278,11563,2715,-0.23480065726887478,10392,10392,0,0.0,3846,3785,61,-0.016116248348745144,0.7278330298361115,0.2693654573469674,0.37009237875288686
interface,DatePrinter,156,132,132,0,0.0,5205,4509,696,-0.15435795076513648,4156,4156,0,0.0,595,555,40,-0.072072072072072,0.7984630163304515,0.1143131604226705,0.1431665062560154
class,FastDateParser,3139,3708,3592,116,-0.03229398663697114,34392,24422,9970,-0.4082384735074933,22896,22896,0,0.0,15873,15324,549,-0.03582615505090048,0.6657362177250523,0.4615317515701326,0.6932651991614256
class,FormatCache,612,718,682,36,-0.05278592375366564,10085,7147,2938,-0.41108157268784096,6735,6735,0,0.0,3064,2712,352,-0.12979351032448383,0.6678235002478929,0.3038175508180466,0.45493689680772087
class,DateFormatUtils,711,731,727,4,-0.005502063273727709,14517,12473,2044,-0.163873967770384,11806,11806,0,0.0,4022,3758,264,-0.07025013304949446,0.8132534270166012,0.2770544878418406,0.3406742334406234
class,DurationFormatUtils,2051,2603,2527,76,-0.03007518796992481,26104,19165,6939,-0.362066266631881,16803,16803,0,0.0,9723,9487,236,-0.024876146305470748,0.6436944529574011,0.37247165185412195,0.5786466702374576
class,FastDatePrinter,4209,4887,4664,223,-0.04781303602058329,48692,31532,17160,-0.5442090574654319,29698,29698,0,0.0,19659,18721,938,-0.05010416110250526,0.6099153865111312,0.403741887784441,0.6619637686039463
class,DateUtils,3531,4262,4132,130,-0.03146176185866412,80217,62733,17484,-0.27870498780546127,58810,58810,0,0.0,17167,16502,665,-0.04029814567931167,0.7331363676028771,0.2140070059962352,0.2919061384118347
interface,DateParser,83,71,71,0,0.0,3947,3453,494,-0.14306400231682592,3210,3210,0,0.0,354,341,13,-0.038123167155425186,0.8132759057512035,0.0896883709146187,0.1102803738317757
